THYM	胸腺
UCEC	子宫
LUAD	肺
LUSC	肺
KICH	肾
CESC	子宫
OV  	卵巢
BRCA	乳腺
COAD	结肠
READ	直肠
BLCA	膀胱
STAD	胃
UCS 	子宫
LIHC	肝
LGG 	脑
ESCA	食道
ACC 	肾上腺
PRAD	前列腺
KIRC	肾
SKCM	皮肤
DLBC	淋巴
KIRP	肾
PAAD	胰腺*
THCA	甲状腺*